"YEAR","CM LAVEL","GWL"
"2010","22","70"
"2011","25","76"
"2012","28","80"
"2013","27","77"
"2014","30","83"
"2015","21","69"
"2016","25","76"
"2017","18","50"
"2018","35","90"
